Example level 1
30 30

073 073 073 073 073 073 073 073 073 073 073 073 073 073 073 073 073 073 073 073 073 073 073 073 073 073 073 073 073 073
073 072 072 072 028 072 072 072 072 072 072 072 072 072 072 072 072 072 072 072 072 072 072 072 072 072 072 072 072 073
073 072 072 072 028 072 072 072 072 072 072 072 072 072 072 072 072 072 072 072 072 072 072 072 072 072 072 072 072 073
073 072 072 072 028 072 072 072 072 072 072 072 072 072 072 072 072 072 072 072 072 072 072 072 072 072 072 072 072 073
073 072 072 072 028 072 072 072 072 072 072 072 072 072 072 072 072 072 072 072 072 072 072 072 072 072 072 072 072 073
073 072 072 072 028 072 072 072 072 072 072 072 072 072 072 072 072 072 072 072 072 072 072 072 072 072 072 072 072 073
073 072 072 072 028 072 072 072 072 072 072 092 094 072 072 072 072 072 072 072 072 072 072 072 072 072 072 072 072 073
073 072 072 072 028 072 111 072 072 028 028 028 028 028 103 103 103 103 072 072 072 072 072 072 072 072 072 072 072 073
073 072 072 072 028 072 072 072 072 028 072 072 072 028 103 103 103 103 072 072 072 072 072 072 072 072 072 072 072 073
073 109 072 072 028 092 072 072 072 028 072 072 072 028 103 103 103 103 072 072 072 072 072 072 072 072 072 072 072 073
073 028 028 028 028 028 028 028 072 028 072 072 072 072 103 103 103 103 072 072 072 072 072 072 072 072 072 072 072 073
073 072 072 072 072 072 111 028 072 028 072 111 072 072 103 103 103 103 072 072 072 072 072 072 072 072 072 072 072 073
073 072 072 072 072 072 072 028 072 028 072 072 072 072 072 072 072 072 072 072 072 072 072 072 072 072 072 072 072 073
073 072 072 072 072 072 072 028 028 028 072 072 072 072 072 072 072 072 072 072 072 072 072 072 072 072 072 072 072 073
073 072 072 072 072 072 072 072 072 072 072 072 072 072 072 072 072 072 072 072 072 072 072 072 072 072 072 072 072 073
073 072 072 072 072 072 072 072 072 072 072 072 072 072 072 072 072 072 072 072 072 072 072 072 072 072 072 072 072 073
073 072 072 072 072 072 072 072 072 072 072 072 072 072 072 072 072 072 072 072 072 072 072 072 072 072 072 072 072 073
073 072 072 072 072 072 072 072 072 072 072 072 072 072 072 072 072 072 072 072 072 072 072 072 072 072 072 072 072 073
073 072 072 072 072 072 072 072 072 072 072 072 072 072 072 072 072 072 072 072 072 072 072 072 072 072 072 072 072 073
073 072 072 072 072 072 072 072 072 072 072 072 072 072 072 072 072 072 072 072 072 072 072 072 072 072 072 072 072 073
073 072 072 072 072 072 072 072 072 072 072 072 072 072 072 072 072 072 072 072 072 072 072 072 072 072 072 072 072 073
073 072 072 072 072 072 072 072 072 072 072 072 072 072 072 072 072 072 072 072 072 072 072 072 072 072 072 072 072 073
073 072 072 072 072 072 072 072 072 072 072 072 072 072 072 072 072 072 072 072 072 072 072 072 072 072 072 072 072 073
073 072 072 072 072 072 072 072 072 072 072 072 072 072 072 072 072 072 072 072 072 072 072 072 072 072 072 072 072 073
073 072 072 072 072 072 072 072 072 072 072 072 072 072 072 072 072 072 072 072 072 072 072 072 072 072 072 072 072 073
073 072 072 072 072 072 072 072 072 072 072 072 072 072 072 072 072 072 072 072 072 072 072 072 072 072 072 072 072 073
073 072 072 072 072 072 072 072 072 072 072 072 072 072 072 072 072 072 072 072 072 072 072 072 072 072 072 072 072 073
073 072 072 072 072 072 072 072 072 072 072 072 072 072 072 072 072 072 072 072 072 072 072 072 072 072 072 072 072 073
073 072 072 072 072 072 072 072 072 072 072 072 072 072 072 072 072 072 072 072 072 072 072 072 072 072 072 072 072 073
073 073 073 073 073 073 073 073 073 073 073 073 073 073 073 073 073 073 073 073 073 073 073 073 073 073 073 073 073 073

0 0 0 0 0 0 0 0 0 0 0 0 0 0 0 0 0 0 0 0 0 0 0 0 0 0 0 0 0 0
0 0 0 0 0 0 0 0 0 0 0 0 0 0 0 0 0 0 0 0 0 0 0 0 0 0 0 0 0 0
0 0 0 0 0 0 0 0 0 0 0 0 0 0 0 0 0 0 0 0 0 0 0 0 0 0 0 0 0 0
0 0 0 0 0 0 0 0 0 0 0 0 0 0 0 0 0 0 0 0 0 0 0 0 0 0 0 0 0 0
0 0 0 0 0 0 0 0 0 0 0 0 0 0 0 0 0 0 0 0 0 0 0 0 0 0 0 0 0 0
0 0 0 0 0 0 0 0 0 0 0 0 0 0 0 0 0 0 0 0 0 0 0 0 0 0 0 0 0 0
0 0 0 0 0 0 0 0 0 0 0 0 0 0 0 0 0 0 0 0 0 0 0 0 0 0 0 0 0 0
0 0 0 0 0 0 0 0 0 0 0 0 0 0 0 0 0 0 0 0 0 0 0 0 0 0 0 0 0 0
0 0 0 0 0 0 0 0 0 0 0 0 0 0 0 0 0 0 0 0 0 0 0 0 0 0 0 0 0 0
0 0 0 0 0 0 0 0 0 0 0 0 0 0 0 0 0 0 0 0 0 0 0 0 0 0 0 0 0 0
0 0 0 0 0 0 0 0 0 0 0 0 0 0 0 0 0 0 0 0 0 0 0 0 0 0 0 0 0 0
0 0 0 0 0 0 0 0 0 0 0 0 0 0 0 0 0 0 0 0 0 0 0 0 0 0 0 0 0 0
0 0 0 0 0 0 0 0 0 0 0 0 0 0 0 0 0 0 0 0 0 0 0 0 0 0 0 0 0 0
0 0 0 0 0 0 0 0 0 0 0 0 0 0 0 0 0 0 0 0 0 0 0 0 0 0 0 0 0 0
0 0 0 0 0 0 0 0 0 0 0 0 0 0 0 0 0 0 0 0 0 0 0 0 0 0 0 0 0 0
0 0 0 0 0 0 0 0 0 0 0 0 0 0 0 0 0 0 0 0 0 0 0 0 0 0 0 0 0 0
0 0 0 0 0 0 0 0 0 0 0 0 0 0 0 0 0 0 0 0 0 0 0 0 0 0 0 0 0 0
0 0 0 0 0 0 0 0 0 0 0 0 0 0 0 0 0 0 0 0 0 0 0 0 0 0 0 0 0 0
0 0 0 0 0 0 0 0 0 0 0 0 0 0 0 0 0 0 0 0 0 0 0 0 0 0 0 0 0 0
0 0 0 0 0 0 0 0 0 0 0 0 0 0 0 0 0 0 0 0 0 0 0 0 0 0 0 0 0 0
0 0 0 0 0 0 0 0 0 0 0 0 0 0 0 0 0 0 0 0 0 0 0 0 0 0 0 0 0 0
0 0 0 0 0 0 0 0 0 0 0 0 0 0 0 0 0 0 0 0 0 0 0 0 0 0 0 0 0 0
0 0 0 0 0 0 0 0 0 0 0 0 0 0 0 0 0 0 0 0 0 0 0 0 0 0 0 0 0 0
0 0 0 0 0 0 0 0 0 0 0 0 0 0 0 0 0 0 0 0 0 0 0 0 0 0 0 0 0 0
0 0 0 0 0 0 0 0 0 0 0 0 0 0 0 0 0 0 0 0 0 0 0 0 0 0 0 0 0 0
0 0 0 0 0 0 0 0 0 0 0 0 0 0 0 0 0 0 0 0 0 0 0 0 0 0 0 0 0 0
0 0 0 0 0 0 0 0 0 0 0 0 0 0 0 0 0 0 0 0 0 0 0 0 0 0 0 0 0 0
0 0 0 0 0 0 0 0 0 0 0 0 0 0 0 0 0 0 0 0 0 0 0 0 0 0 0 0 0 0
0 0 0 0 0 0 0 0 0 0 0 0 0 0 0 0 0 0 0 0 0 0 0 0 0 0 0 0 0 0
0 0 0 0 0 0 0 0 0 0 0 0 0 0 0 0 0 0 0 0 0 0 0 0 0 0 0 0 0 0

0 0 0 0 0 0 0 0 0 0 0 0 0 0 0 0 0 0 0 0 0 0 0 0 0 0 0 0 0 0
0 0 0 0 0 0 0 0 0 0 0 0 0 0 0 0 0 0 0 0 0 0 0 0 0 0 0 0 0 0
0 0 0 0 0 0 0 0 0 0 0 0 0 0 0 0 0 0 0 0 0 0 0 0 0 0 0 0 0 0
0 0 0 0 0 0 0 0 0 0 0 0 0 0 0 0 0 0 0 0 0 0 0 0 0 0 0 0 0 0
0 0 0 0 0 0 0 0 0 0 0 0 0 0 0 0 0 0 0 0 0 0 0 0 0 0 0 0 0 0
0 0 0 0 0 0 0 0 0 0 0 0 0 0 0 0 0 0 0 0 0 0 0 0 0 0 0 0 0 0
0 0 0 0 0 0 0 0 0 0 0 0 0 0 0 0 0 0 0 0 0 0 0 0 0 0 0 0 0 0
0 0 0 0 0 0 0 0 0 0 0 0 0 0 0 0 0 0 0 0 0 0 0 0 0 0 0 0 0 0
0 0 0 0 0 0 0 0 0 0 0 0 0 0 0 0 0 0 0 0 0 0 0 0 0 0 0 0 0 0
0 0 0 0 0 0 0 0 0 0 0 0 0 0 0 0 0 0 0 0 0 0 0 0 0 0 0 0 0 0
0 0 0 0 0 0 0 0 0 0 0 0 0 0 0 0 0 0 0 0 0 0 0 0 0 0 0 0 0 0
0 0 0 0 0 0 0 0 0 0 0 0 0 0 0 0 0 0 0 0 0 0 0 0 0 0 0 0 0 0
0 0 0 0 0 0 0 0 0 0 0 0 0 0 0 0 0 0 0 0 0 0 0 0 0 0 0 0 0 0
0 0 0 0 0 0 0 0 0 0 0 0 0 0 0 0 0 0 0 0 0 0 0 0 0 0 0 0 0 0
0 0 0 0 0 0 0 0 0 0 0 0 0 0 0 0 0 0 0 0 0 0 0 0 0 0 0 0 0 0
0 0 0 0 0 0 0 0 0 0 0 0 0 0 0 0 0 0 0 0 0 0 0 0 0 0 0 0 0 0
0 0 0 0 0 0 0 0 0 0 0 0 0 0 0 0 0 0 0 0 0 0 0 0 0 0 0 0 0 0
0 0 0 0 0 0 0 0 0 0 0 0 0 0 0 0 0 0 0 0 0 0 0 0 0 0 0 0 0 0
0 0 0 0 0 0 0 0 0 0 0 0 0 0 0 0 0 0 0 0 0 0 0 0 0 0 0 0 0 0
0 0 0 0 0 0 0 0 0 0 0 0 0 0 0 0 0 0 0 0 0 0 0 0 0 0 0 0 0 0
0 0 0 0 0 0 0 0 0 0 0 0 0 0 0 0 0 0 0 0 0 0 0 0 0 0 0 0 0 0
0 0 0 0 0 0 0 0 0 0 0 0 0 0 0 0 0 0 0 0 0 0 0 0 0 0 0 0 0 0
0 0 0 0 0 0 0 0 0 0 0 0 0 0 0 0 0 0 0 0 0 0 0 0 0 0 0 0 0 0
0 0 0 0 0 0 0 0 0 0 0 0 0 0 0 0 0 0 0 0 0 0 0 0 0 0 0 0 0 0
0 0 0 0 0 0 0 0 0 0 0 0 0 0 0 0 0 0 0 0 0 0 0 0 0 0 0 0 0 0
0 0 0 0 0 0 0 0 0 0 0 0 0 0 0 0 0 0 0 0 0 0 0 0 0 0 0 0 0 0
0 0 0 0 0 0 0 0 0 0 0 0 0 0 0 0 0 0 0 0 0 0 0 0 0 0 0 0 0 0
0 0 0 0 0 0 0 0 0 0 0 0 0 0 0 0 0 0 0 0 0 0 0 0 0 0 0 0 0 0
0 0 0 0 0 0 0 0 0 0 0 0 0 0 0 0 0 0 0 0 0 0 0 0 0 0 0 0 0 0
0 0 0 0 0 0 0 0 0 0 0 0 0 0 0 0 0 0 0 0 0 0 0 0 0 0 0 0 0 0
